alreadyConnected=Nodes already connected
cancel=Cancel
close=Close
collapse-expand=Collapse/Expand
containsValidationErrors=Contains validation errors
done=Done
doubleClickOrientation=Doubleclick to Change Orientation
error=Error
errorSavingFile=Error saving file
ok=OK
updatingDocument=Updating Document. Please wait...
updatingSelection=Updating Selection. Please wait...
# Custom resources
about=About
actualSize=Actual Size
add=Add
addLayer=Add Layer
addProperty=Add Property
addToExistingDrawing=Add to Existing Drawing
addWaypoint=Add Waypoint
advanced=Advanced
align=Align
alignment=Alignment
allChangesLost=All changes will be lost!
angle=Angle
apply=Apply
arc=Arc
arrange=Arrange
arrow=Arrow
arrows=Arrows
automatic=Automatic
autosave=Autosave
autosize=Autosize
background=Background
backgroundColor=Background Color
backgroundImage=Background Image
basic=Basic
block=Block
blockquote=Blockquote
bold=Bold
borderWidth=Borderwidth
borderColor=Border Color
bottom=Bottom
bottomAlign=Bottom Align
bottomLeft=Bottom Left
bottomRight=Bottom Right
bulletedList=Bulleted List
cannotOpenFile=Cannot open file
center=Center
change=Change
changeOrientation=Change Orientation
circle=Circle
classic=Classic
clearDefaultStyle=Clear Default Style
clearWaypoints=Clear Waypoints
clipart=Clipart
collapse=Collapse
collapseExpand=Collapse/Expand
collapsible=Collapsible
comic=Comic
connect=Connect
connection=Connection
connectionPoints=Connection points
connectionArrows=Connection arrows
constrainProportions=Constrain Proportions
copy=Copy
copyConnect=Copy on Connect
create=Create
curved=Curved
custom=Custom
cut=Cut
dashed=Dashed
decreaseIndent=Decrease Indent
default=Default
default_label=Default
delete=Delete
deleteColumn=Delete Column
deleteRow=Delete Row
diagram=Diagram
diamond=Diamond
diamondThin=Diamond (thin)
direction=Direction
distribute=Distribute
divider=Divider
documentProperties=Document Properties
dotted=Dotted
drawing=Drawing{1}
drawingEmpty=Drawing is empty
drawingTooLarge=Drawing is too large
duplicate=Duplicate
duplicateIt=Duplicate {1}
east=East
edit=Edit
editData=Edit Data
editDiagram=Edit Diagram
editImage=Edit Image
editLink=Edit Link
editStyle=Edit Style
editTooltip=Edit Tooltip
enterGroup=Enter Group
enterValue=Enter Value
enterName=Enter Name
enterPropertyName=Enter Property Name
entityRelation=Entity Relation
exitGroup=Exit Group
expand=Expand
export=Export Diagram
extras=Extras
file=File
fileNotFound=File not found
filename=Filename
fill=Fill
fillColor=Fill Color
fitPage=One Page
fitPageWidth=Page Width
fitTwoPages=Two Pages
fitWindow=Fit Window
flip=Flip
flipH=Flip Horizontal
flipV=Flip Vertical
font=Font
fontFamily=Font Family
fontColor=Font Color
fontSize=Font Size
format=Format
formatPanel=Format Panel
formatPdf=PDF
formatPng=PNG
formatGif=GIF
formatJpg=JPEG
formatSvg=SVG
formatXml=XML
formatted=Formatted
formattedText=Formatted Text
gap=Gap
general=General
glass=Glass
global=Global
gradient=Gradient
gradientColor=Color
grid=Grid
gridSize=Grid Size
group=Group
guides=Guides
heading=Heading
height=Height
help=Help
hide=Hide
hideIt=Hide {1}
hidden=Hidden
home=Home
horizontal=Horizontal
horizontalFlow=Horizontal Flow
horizontalTree=Horizontal Tree
html=HTML
image=Image
images=Images
import=Import Diagram
exportTree=Export Tree
importTree=Import Tree
increaseIndent=Increase Indent
insert=Insert
insertColumnBefore=Insert Column Left
insertColumnAfter=Insert Column Right
insertHorizontalRule=Insert Horizontal Rule
insertImage=Insert Image
insertLink=Insert Link
insertRowBefore=Insert Row Above
insertRowAfter=Insert Row Below
invalidName=Invalid name
invalidOrMissingFile=Invalid or missing file
isometric=Isometric
italic=Italic
layers=Layers
landscape=Landscape
laneColor=Lanecolor
layout=Layout
left=Left
leftAlign=Left Align
leftToRight=Left to Right
line=Line
link=Link
lineJumps=Line jumps
lineend=Line End
lineheight=Line Height
linestart=Line Start
linewidth=Linewidth
loading=Loading
lockUnlock=Lock/Unlock
manual=Manual
middle=Middle
misc=Misc
more=More
moreResults=More Results
move=Move
moveSelectionTo=Move Selection to {1}
navigation=Navigation
new=New
newTree=New Tree
newComponent=New Component
openComponent=Open Component
noColor=No Color
noFiles=No files
noMoreResults=No more results
none=None
noResultsFor=No results for '{1}'
normal=Normal
north=North
numberedList=Numbered List
opacity=Opacity
open=Open
openTree=Open Tree
openArrow=Open Arrow
openFile=Open File
openLink=Open Link
openSupported=Supported format is .json file
openInNewWindow=Open in New Window
openInThisWindow=Open in this Window
options=Options
organic=Organic
orthogonal=Orthogonal
outline=Outline
oval=Oval
pages=Pages
pageView=Page View
pageScale=Page Scale
pageSetup=Page Setup
panTooltip=Space+Drag to Scroll
paperSize=Paper Size
paste=Paste
pasteHere=Paste Here
pattern=Pattern
perimeter=Perimeter
placeholders=Placeholders
plusTooltip=Click to connect and clone (ctrl+click to clone, shift+click to connect). Drag to connect (ctrl+drag to clone).
portrait=Portrait
position=Position
posterPrint=Poster Print
preview=Preview
print=Print
radialTree=Radial Tree
redo=Redo
removeFormat=Clear Formatting
removeFromGroup=Remove from Group
removeIt=Remove {1}
removeWaypoint=Remove Waypoint
rename=Rename
renameIt=Rename {1}
replace=Replace
replaceIt={1} already exists. Do you want to replace it?
replaceExistingDrawing=Replace existing drawing
reset=Reset
resetView=Reset View
reverse=Reverse
right=Right
rightAlign=Right Align
rightToLeft=Right to Left
rotate=Rotate
rotateTooltip=Click and drag to rotate, click to turn by 90 degrees
rotation=Rotation
rounded=Rounded
save=Save
saveAs=Save as
saved=Saved
scrollbars=Scrollbars
search=Search
searchShapes=Search Assets
selectAll=Select All
selectEdges=Select Edges
selectFont=Select a Font
selectNone=Select None
selectVertices=Select Vertices
setAsDefaultStyle=Set as Default Style
shadow=Shadow
shape=Shape
sharp=Sharp
sidebarTooltip=Click to expand. Drag and drop shapes into the diagram. Shift+click to change selection. Alt+click to insert and connect.
simple=Simple
simpleArrow=Simple Arrow
size=Size
size_help=Size
solid=Solid
sourceSpacing=Source Spacing
south=South
spacing=Spacing
straight=Straight
strokeColor=Line Color
style=Style
subscript=Subscript
superscript=Superscript
table=Table
targetSpacing=Target Spacing
text=Text
textAlignment=Text Alignment
textOpacity=Text Opacity
toBack=To Back
toFront=To Front
tooltips=Tooltips
top=Top
topAlign=Top Align
topLeft=Top Left
topRight=Top Right
transparent=Transparent
turn=Rotate 90
uml=UML
underline=Underline
undo=Undo
ungroup=Ungroup
url=URL
untitledLayer=Untitled Layer
vertical=Vertical
verticalFlow=Vertical Flow
verticalTree=Vertical Tree
view=View
waypoints=Waypoints
west=West
width=Width
wordWrap=Word Wrap
writingDirection=Writing Direction
zoom=Zoom
zoomIn=Zoom In
zoomOut=Zoom Out
property=Property
forestName=Application Name
treeName=Tree Name
setLocalVar=Set Local Variable
localVarSetting=Local Variable Setting
enterVarName=Enter Variable Name
enterInitVal=Enter Init Value
lookAndFeel=Look And Feel
id=Id
appId=App Id
versionId=Version Id
searchCriteria=Search Criteria
name=Name
type=Type
type_help=Type
setCdrParams=Set Params
setAssignNodeVal=Set Variables
queryStatement=Query Statement
results_in=Results_In
query=IsQuery
isReadOnly=readOnly
dbNodeVariableMap=Set Variable
dbQuerySpecifierMap=Set Query Specifier
functionName=Function Name
arg1=Argument 1
arg2=Argument 2
arg3=Argument 3
dropIvrOnCompletion=Drop IVR on Completion
maxRetries=Maximum Retries
literal=Literal
variable=Variable
httpReqJSON=HttpReqJSON
caseMap=Set Case
sendMode=Send Mode
connectionMode=Connection Mode
dropCallMode=Drop Call Mode
treeId=Tree Id
enterCaseVal=Enter Case Value
enterNodeId=Enter Node Id
enterVal=Enter Value
cdrParamSetting=CDR Param Setting
enterDesc=Enter Description
entercdrValue=Enter CDR Value
dbVarSetting=DB Variable Setting
dbQuerySetting=DB Query Setting
enterPosition=Enter Position
enterInOrOut=Enter In or Out
assignValSetting=Set Assignment Value
enterFrom=Enter From
enterTo=Enter To
switchVarSetting=Switch Case Setting
smsVarSetting=SMS Variables Setting
enterLabel=Enter Label
enterSmslabelMX=Enter Label MX
enterSize=Size
maxLength=Max Length
minVal=Min Val
maxVal=Max Val
isRequired=Is Required
isRequired_help=Is Required
smsType=SMS Type
fieldType=Field Type
fieldType_help=Field Type
dataType=Data Type
dataType_help=Data Type
setSMSVar=Set SMS Variables
delimiter=Delimiter
variableName=Variable Name
variableName_help=Variable Name
label=Label
label_help=Label
labelMX=Label MX
labelMX_help=Label MX
range=Range
procquery=Proc Query
package=Package
version=Version
arg1Type=Argument Type1
arg2Type=Argument Type2
arg3Type=Argument Type3
saveUiXml_int=Save Tree
saveComponent_int=Save Component
loadComponent_dlg=Load Component
loadTreeDialog=Load Tree
loadTreeHeading=Load Tree Specification
loadTreeDiagram=Load
loadFunctionDiagram=Load
repeat=Repeat
barge=Barge
returnKey=Return Key
escapeKey=Escape Key
firstDigitTimer=First Digit Timer (sec)
interDigitTimer=Inter Digit Timer (sec)
minDigit=Min Digit
maxDigit=Max Digit
playItem=Play Item
playAndCollectItemDialog=Play And Collect Items Configuration
playItemDialog=Play Items Configuration
enterType=Enter Type
enterHtmlType=Enter Html Type
enterVariableName=Enter Var Name
LHS=LHS
RHS=RHS
output=Output
operation=Operation
portMethodName=Port Method
serviceClassName=Service Class
setInputList=Set Input List
setOutputList=Set Output List
enterKey=Enter Key
outputListSetting=Output List Setting
inputListSetting=Input List Setting
unsetAssignNodeVal=Unset Variables
assignUnsetVarSetting=Unset Variables Setting
earlyMedia=Early Media
enterSubtype=Enter Sub Type
enterAnnType=Enter Ann Type
nextNodeId=Node Id
openTree=Open Tree
saveTemplateDialog=Save as Template
loadTemplateDialog=Load from Template
templateName=Template Name
saveTemplateBtn=Save
loadTemplateBtn=Load
enterDefaultValue=Enter Default Value
downloadServiceXml_int=Download Service XML
deleteDialog=Delete
deleteForest=Delete Application
deleteTree=Delete Tree
fileName=File Name
validate=Validate
develop_int=Develop
test_int=Test
deploy_int=Deploy
activate_int=Activate
submit=Submit
avilableCdr=Available CDR
appName=App Name
variableManagement=Variable Management
from=From
fromVariable=From Variable
smsLabel=SMS Label
htmlType=HTML Type
htmlType_help=HTML Type
varName=Var Name
isAnnouncement=Is Announcement
subType=Sub Type
announcementType=Announcement
value=Value
value_help=Value
returnAnn=Return Ann
annType=Ann Type
defaultValue=Default Value
defaultValue_help=Default Value
smsVariable=SMS Variable
valueType=Value Type
key=Key
arrayResponse=Array Response
initVal=Init Value
initVal_help=Init Value
description=Description
description_help=Description
cdrType=CDR Type
cdrValue=CDR Value
toVariable=To
fromType=From Type
fromValue=From Value
inOrOut=In Or Out
parsingStyle=Parsing Style
isRetry=Is Retry
forestName_help=Application Name
treeName_help=Tree Name
id_help=Id
appId_help=Application Id
versionId_help=Version Id
searchCriteria_help=Search Criteria
setLocalVar_help=Local Variable Setting
setSMSVar_help=SMS Variables Setting
help_help=Help Link
delimiter_help=Delimiter
setCdrParams_help=CDR Params
setAssignNodeVal_help=Assign Node Set Values
unsetAssignNodeVal_help=Assign Node Unset Values
package_help=Package
version_help=Version
procquery_help=Proc query
results_in_help=DB Results
query_help=Query
dbQuerySpecifierMap_help=Query Specifier Setting
functionName_help=Function Name
LHS_help=LHS
RHS_help=RHS
output_help=Output
arg1Type_help=Argument Type1
arg2Type_help=Argument Type2
arg3Type_help=Argument Type3
treeId_help=Tree Id
nextNodeId_help=Node Id
openTree_help=Open Tree
dropIvrOnCompletion_help=Ivr Completion
connectionMode_help=Connection Mode
maxRetries_help=Maximum Retries
repeat_help=Repeat
barge_help=Barge
returnKey_help=Return Key
escapeKey_help=Escape Key
firstDigitTimer_help=First Digit Timer
interDigitTimer_help=Inter Digit Timer
minDigit_help=Min Digit
maxDigit_help=Max Digit
playItem_help=Play Item
earlyMedia_help=Early Media
portMethodName_help=Port Method Name
serviceClassName_help=Service Class Name
operation_help=Operation
setInputList_help=Input List Setting
setOutputList_help=Output List Setting
variable_help=Variable
sendMode_help=Send Mode
dropCallMode_help=Drop Call Mode
openServiceXmlDialog=Open Service XML
noLabel=
noLabel_help=
localVarSettings=Local Variables Settings
action=Action
createAppDialog=Create App Dialog
createForestDialog=Create Application
deleteDiagram=Delete Application/Tree
load=Load
smsValue=SMS Value
smsValue_help=SMS Value
maxActiveSpeaker=Max Active Speaker
maxActiveSpeaker_help=Maximum Active Speaker
notifyActiveSpeaker=Notify Active Speaker
notifyActiveSpeaker_help=Notify Active Speaker
notificationInterval=Notification Interval
notificationInterval_help=Notification Interval
destroyCriteria=Destroy Criteria
destroyCriteria_help=Destroy Criteria
playAnnBeforeRecording=Play Ann Before Recording
playAnnBeforeRecording_help=Play Ann Before Recording
recordingPath=Recording Path
recordingPath_help=Recording Path
recordingFilename=Recording File Name
recordingFilename_help=Recording File Name
recordingFormat=Recording Format
recordingFormat_help=Recording Format
recordingDuration=Recording Duration
recordingDuration_help=Recording Duration
recordingTerminationKey=Recording Termination Key
recordingTerminationKey_help=Recording Termination Key
callControl=Call Control
routing=Routing
string=String
integer=Integer
phone=Phone
diameterAvpList=Diameter AVP List
terminating=Terminating
originating=Originating
neutral=Neutral
addNewApp=+ New Application
addNewForest=+ New Application
addNewVariable=+ New Variable
afeLength=Length
afeLength_help=Length
min=Min
max=Max
announcement=Announcement
spccarrier=SpcCarrier
phoneNumberType=Phone Number
alphaNumericType=Alpha Numeric
timePatternType=Time Pattern
originPatternType=Origin Pattern
comma=Comma
pipe=Pipe
shape_start=Start
shape_save_cdr=Save CDR
shape_interm_cdr=Interm CDR
shape_assignment=Assignment
shape_db_call=DB Call
shape_condition=Condition
shape_expression=Expression
shape_connect=Connect
shape_play_and_collect=Play And Collect
shape_play=Play
shape_external_call=External Call
shape_switch=Switch
shape_route_call=Route Call
shape_terminate=Terminate
shape_time_pattern=Time Pattern
shape_origin_pattern=Origin Pattern
shape_create_conference=Create Conference
shape_join_conference=Join Conference
shape_unjoin_conference=UnJoin Conference
conferenceID=Conference ID
timer=Timer
shape_destroy_conference=Destroy Conference
shape_record=Record
shape_stop_media=Stop Media
shape_tree_node=Tree Node
shape_function_block=Function Block
shape_sequence=Sequence
shape_table=Table
shape_view=View
shape_user_type=User Type
shape_sip_header=SIP Header
shape_smpp=SMPP
shape_gdi=GDI
shape_checkpoint=checkpoint
shape_service_chaining=Service Chaining
shape_ati=ATI
shape_ccb=CCB
shape_udr=UDR
shape_force_call_cleanup=Force Call Cleanup
shape_echo_data=Echo Data
shape_disconnect_leg= Disconnect Leg
shape_call_queuing=Call Queuing
shape_playspeech=Play Speech
resultSet=ResultSet
compare=Compare
compareIgnoreCase=Compare Ignore Case
notNull=Not Null
startsWith=Starts With
startsWith_help=Start With
equalTo=Equal To
notEqualTo=Not Equal To
greaterThan=Greater Than
greaterThanEqualTo=Greater Than Or Equal To
lessThan=Less Than
lessThanEqualTo=Less Than Or Equal To
true=True
false=False
assist=Assist
hashKey=#
asteriskKey=*
end=End
continue=Continue
rerouting=ReRouting
b2bua=B2BUA
eqsrouting=EQSRouting
portRouting=Port Routing
direct_ms=Direct MS
proxy_stateful=ProxyStateful
proxy_stateless=ProxyStateless
releaseCall=Release Call
userAbort=User Abort
userReject=User Reject
wav=Wav
subStr=SubString
append=Append
add=Add
subtract=Subtract
toUpper=To Upper Case
toLower=To Lower Case
redirection=Redirection
noControl=No Control
noMedia=No Media
never=Never
variableAnnouncement=Variable
staticAnnouncement=Static
smsAnnouncement=SMS
date=Date
digit=Digit
duration=Duration
money=Money
month=Month
number=Number
silence=Silence
time=Time
weekday=Week day
mdy=mdy
dmy=dmy
ymd=ymd
gen=gen
ndn=ndn
crd=crd
ord=ord
t12=t12
t24=t24
sip=SIP
ituinapcs1_scf=ITUINAPCS1_SCF
ain_scfprotocol=AIN_SCFProtocol
capv2_scf=CAPV2_SCF
ituinapcs2_scf=ITUINAPCS2_SCF
ss7=SS7
staticAnnType=Static Ann Type
toVariable_help=To Variable
from_help=From
key_help=Key
arrayResponse_help=Array Response
announcementType_help=Announcement Type
isRetry_help=Retry
annType_help=Static Announcement Type
smsVariable_help=SMS Variable
subType_help=Sub Type
treeVersion=Tree Version
appVersionId=App Version Id
addNew=Add New
update=Update
na=Not Applicable
USD=US Dollar
treeVersion_help=Tree Version
appVersionId_help=Version Id
shape_event_handler=Event Handler
resultFound=Result Found
resultsNotFound=Results Not Found
exceptionFound=Exception Found
noConnectionFound=No Connection Found
success=Success
success_label=Success
failure=Failure
failure_label=Failure
connectionFailed=Connection Failed
noSpeech=No Speech
speechServerError=Speech Server Error
timeout= Timeout
eventUnknown=Event Unknown
eventDisconnect=Event Disconnect
eventAppTimer=Event App Timer Timeout
eventInitialize=Event Initialize 
eventDtmf=Event DTMF
default=Default
nonDefault=Non Default
nonDefault_label=Non Default
properties=Properties
navigator=Navigator
critical=Critical
error=Error
clob=Clob
in=In
out=Out
inout=InOut
warning=Warning
failedServerResponse=The following error occurs on sending your request to server. Contact your admin.
failedValidation=Please correct the following errors.
failedServerResponse=The following error occurred on sending your request to server. Contact your admin.
sessionTimedOutResponse=Session has been timed out.
successLoadDBResponse=The DB schema has been loaded into the DB specified DB Details successfully.
wrongDataNotification=Make sure all inputs have been set properly.
pipe=Pipe
comma=Comma
varType=Value Type
parsingstyle=Parsing Style
shape_create_timer=Create Timer
timerName=Timer Name
timerName_help=Timer Name
duration_help=Duration
seconds=Seconds
milliseconds=Milli Seconds
minutes=Minutes
timeunit=Time Unit
timeunit_help=Time Unit
search_help=Search
navigator_help=Navigator
toggleHeader_help=Toggler Header
toggleRightPanel_help=Toggle Right Panel
fullScreen_help=Full Screen
searchString=Search String 
node=Node
show=Show
generalAssets=General Assets
mediaAssets=Media Assets
enterpriseAssets=Enterprise Assets
routingEngineAssets=Routing Assets
keepAsTemplate=Keep As Template
createFromTemplate=Create From Template
buildFromServiceXML=Build From ServiceXML
group_generalAssets=GA
group_mediaAssets=MA
group_enterpriseAssets=EA
group_applicationAssets=AA
group_routingEngineAssets=RA
applicationAssets=Application Assets
storeOutput=Store Collected Digit in
storeOutput_help=Store Collected Digit in
closeToggleSidebar=Collapse Sidebar
shape_block_pattern=Block Pattern
shape_call_area_screening=Call Area Screening
checkLength=Check Length
increment=Increment
decrement=Decrement
blocknumpattern=Block Pattern
callAreaScreening=Call Area Screening
shape_account_code=Account Code
shape_dialed_pattern=Dialed pattern
dialedPattern=Dialed Pattern
shape_percentage=Percentage
percentageInfo=Percentage-Info
percentageInfo_label=Percentage-Info
shape_stop_timer=Stop Timer
timerName=Timer Name
timerName_help=Timer Name
mandatoryValidated=Mandatory Validated
mandatoryNonValdiated=Mandatory Non-Valdiated
nonMandatoryValidated=Non-Mandatory Validated
nonMandatoryNonValidated=Non-Mandatory Non-Validated
checkFixLength=Fix Length
noCheckLength=No Fix Length
outboundAddress=Out Bound Address
outboundAddress_help=Out Bound Address
shape_call_hold=Call Hold
shape_digit_pattern=Digit Pattern
playMusicOnHold=Play Music On Hold
playMusicOnHold_help=Play Music On Hold
playAnnType=Play Ann Type
playAnnType_help=Play Ann Type
playAnn=Play Announcement
playAnn_help=Play Ann
authorization=Authorization
PINBasedDigitValidation=PIN Based Digit Validation
extensions=Extensions
invalidInputAnn=Invalid Input Announcement
invalidInputAnn_help=Invalid Input Ann
invalidInputAnnType=Invalid Input Ann Type
invalidInputAnnType_help=Invalid Input Ann Type
noInputAnn=No Input Announcement
noInputAnn_help=No Input Ann
noInputAnnType=No Input Ann Type
noInputAnnType_help=No Input Ann Type
digitPattern=Digit Pattern
digitPattern_help=Digit Pattern
validPatternList=Valid Pattern List
validPatternList_help=Valid Pattern List
validationType=Validation Type
validationType_help=Validation Type
checkFixLength=Check Fix Length
checkFixLength_help=Check Fix Length
accountCodeLength=Length
accountCodeLength_help=Length
patternType=Pattern Type
patternType_help=Pattern Type
retryAttempts=Retry Attempts
retryAttempts_help=Retry Attempts
loadComponentHeading=Load Component Specification
componentName=Function Block Name
componentName_help=Function Block Name
treeName=Tree Name
viewTree=View Tree
viewTree_help=View Tree
viewFunctionBlock=View Function Block
viewFunctionBlock_help=View Function Block
blockName=Function Block Name
blockName_help=Function Block Name
debug_help=Debug
newTree=New Tree
newComponent=New Component
newForest=New Forest
debugItemStart_help=Start
debugItemFirst_help=First
debugItemNext_help=Next
debugItemPrev_help=Previous
debugItemLast_help=Last
debugItemClose_help=Close
saveAsTemplate_help=Save As Template
navigator_help=Navigator
toggleLeftPanel_help=Toggle Left Panel
toggleHeader_help=Toggle Header
toggleRightPanel_help=Toggle Right Panel
fullScreen_help=Full Screen
deleteComponent=Delete Component
downloadComponent=Download Component
loadFunctionBlockTemplateDialog=Load From Template
deleteFunctionTemplateDialog=Delete Template
deleteTreeTemplateDialog=Delete Template
deleteTemplateBtn=Delete Template
deleteFunctionBlockTemplate=Delete Function Block Template
deleteTreeTemplate=Delete Tree Template
addNewFunctionBlock=+ New Function Block
createFunctionBlockDialog=Create Function Block
addNewTree=+ New Tree
createTreeDialog=Create Tree
connector=Connector
newProcess=New Process
loadProcess_dlg=Load Process
saveProcessDialog=Save As Process
openProcess=Open Process
openProcess_help=Open Process
downloadProcess=Download Process
saveProcess_int=Save Process
deleteProcessDialog=Delete Process
loadProcess=Load Process
shape_process_call=Process Call
shape_process_start=Process Start
shape_return=Return
loadProcessDiagram=Load Process Diagram
importProcess=Import Process
exportProcess=Export Process
processName=Process Name
processName_help=Process Name
deleteProcess=Delete Process
processVersion=Process Version
processVersion_help=Process Version
saveAsProcess=Save As Process
connectParty=Connect Party
connectParty_help=Connect Party
orig=Origin
term=Term
ORIG=ORIG
TERM=TERM
disconnectLeg= Disconnect Leg
patternId=Pattern Id
patternId_help=Pattern Id
selectPattern=Select Pattern
selectPattern_help=Select Pattern
shape_resync_call=Resync Call
processVar=Process Variable
processVar_help=Process Variable
invarType=In Type
invarType_help=In Type
inVar=In
inVar_help=In
outVar=Out
outVar_help=Out
setProcessVar=Set Process Variables
setProcessVar_help=Set Process Variables
processVarSetting=Process Variable Setting
dialedPattern=Dialed Pattern
searchPattern=Search Pattern
searchPattern_help=Search Pattern
timePattern=Time Pattern
originPattern=Origin Pattern
blockPattern=Block Pattern
callAreaScreeningPattern=Call Area Screening Pattern
uiXml=User Saved Xml
autoSavedXml=Auto Saved Xml
selectTypeOfXmlToProceed=Select Type Of Xml To Proceed
digitPattern=Digit Pattern
forward=Forward
reverse=Reverse
directionOfConnection=Direction Of Connection
directionOfConnection_help=Direction Of Connection
dialoutMode=Dialout Mode
dialoutMode_help=Dial Mode
shape_dialout_call=Dialout Call
pindigitpattern=Pin Based Digit Pattern
extndigitpattern=Extension Based Digit Pattern
authdigitpattern=Authorization Based Digit Pattern
none=NONE
disconnectParty=Disconnect Party
disconnectParty_help=Disconnect Party
eventHandlerId=Event Handler Id
eventHandlerId_help=Event Handler Id
global=Global
local=Local
handlerType=Handler Type
handlerType_help=Handler Type
callAssets=Call Assets
group_callAssets=CA
configureCAS=Configure CAS
casConfigureDialog=CAS Details
casGroupConfigureDialog=CAS Group Details
manageCASDialog=Manage CAS
ip=IP Address
port=Port Number
ip_help=IP Address
port_help=Port Number
settings=Settings
refreshApplications=Refresh Applications
deployApplication=Deploy Application
manageCASApplicationsDialog=Manage CAS Applications
manageCASGroupDialog=Manage CAS Group
availableCASServers=Available CAS Servers
availableCASServers_help=Available CAS Servers
applicationName=Application Name
deployer=Deployer
status=Status
active=Active
activate=Activate
deactivate=Deactivate
start=Start
stop=Stop
undeploy=Undeploy
applicationInfo=Application Info
casApplicationInfo=CAS Application Info
name_help=Name
availableApplications=Available Applications
availableApplications_help=Available Applications
ready=Ready
installed=Installed
priority=Priority
priority_help=Priority
packageApplicationDialog=Package Application
packageApplication=Package Application
successDialog=Success Message
downloadApplicationPackage=Download Application
failedToCreateApplicationPackage=The following error occurred on creating application package. Contact your admin.
userDefinedDBSchema=User Defined DB Schema
uploadSchema=Upload Schema
uploadSchema_help=Upload Schema
showDBSchema=Show DB Schema
showDBSchema_help=Show DB Schema
uploadForestDBSchema=Upload Application DB Schema
appRouterDialog=App Router Config
sipMethod=SIP Method
sipMethod_help=SIP Method
sipHeader=SIP Header
sipHeader_help=SIP Header
routingRegion=Routing Region
routingRegion_help=Routing Region
routeModifier=Route Modifier
routeModifier_help=Route Modifier
regex=Regex
regex_help=Regex
infoDialog=Info
invite=Invite
subscribe=Subscribe
casNotConfiguredError=Please configure CAS before managing CAS.
emptyCasServersData=Empty CAS Servers Data.
applicationPackageCreated=Your application package has been successfully created :
applicationPackageFailed=Failed to Create Application Package. Application is: 
register=Register
options=Options
message=Message
to=To
from=From
noRoute=No Route
route=Route
routeBack=Route Back
ignore=Ignore Rule
ignore_help=Ignore Rule
appRoutingRuleDialog=Apply Routing Rules
casServer=CAS Server
casServer_help=CAS Server
applicationRoutingRule=Application Routing Rule
setRoutingRules=Set Routing Rules
launchApplication=Launch Application
launchApplication_help=Launch Application
closeApplication=Close Application
helpDialog=Info
dbDetailDialog=DB Detail
schemaBuilderDiagram=Schema Builder
user=User
user_help=User
password=Password
password_help=Password
scheme=Scheme
scheme_help=Scheme
host=Host
host_help=Host
type=Type
dbDetailsConfig=DB Config
oracle=Oracle
postgres=Postgres
dbSchema=DB Schema
manageColumns=Manage Columns
tableColumnDialog=Columns Info
lengthVal=Length
required=Is Required
nullCheck=Is Null
char=CHAR
numberDataType=NUMBER
nChar=NCHAR
varChar2=VARCHAR2
binaryFloat=BINARY FLOAT
binaryDouble=BINARY DOUBLE
float=FLOAT
long=LONG
date=DATE
null=Null
asDefined=As Defined
manageColumns_help=Manage Columns
manageIndexes=Manage Indexes
manageIndexes_help=Manage Indexes
manageRelations=Manage Relations
manageRelations_help=Manage Relations
indexType=Index Type
columns=Columns
primary=PRIMARY
composite=COMPOSITE
foreign=FOREIGN
unique=UNIQUE
fullText=FULLTEXT
tableIndexDialog=Manage Indexes
saveDBSchema_int=Save DBSchema
manageConstraints=Manage Constraints
manageConstraints_help=Manage Constraints
nVarchar2=NVARCHAR2
longRaw=LONG RAW
raw=RAW
timestamp=TIMESTAMP
intervalYear=INTERVAL YEAR
intervalDay=INTERVAL DAY
blob=BLOB
clobDataType=CLOB
nclob=NCLOB
bfile=BFILE
rowId=ROWID
uRowId=UROWID
formula=FORMULA
sizeType=Size Type
sizeType_help=Size Type
timezone=TIMEZONE
localTimezone=LOCAL TIMEZONE
timestampType=Timestamp Type
timestampType_help=Timestamp Type
precision=Precision
precision_help=Precision
scale=Scale
scale_help=Scale
secondsPrecision=Seconds Precision
secondsPrecision_help=Seconds Precision
isSort=Is Sort
isSort_help=Is Sort
defaultVal=Default
defaultVal_help=Default
nullVal=Null Value
apiName=Api Variable Name
nullVal_help=Null Value
sort=Sort
byte=BYTE
formulaText=Formula Text
formulaText_help=Formula Text
max=Maximum
max_help=Maximum
min=Minimum
min_help=Minimum
noLimit=No Limit
incrementBy=Increment By
incrementBy_help=Increment By
maxVal=Maximum Value
maxVal_help=Maximum Value
minVal=Minimum Value
minVal_help=Minimum Value
manageConstraintsDialog=Manage Constraints Dialog
addItem=Add Item
removeItem=Remove Item
primarykey=PRIMARY KEY
check=CHECK
foreignkey=FOREIGN KEY
nonSelectedColumns=Non Selected Cols
nonSelectedColumns_help=Non Selected Cols
remove=Remove
selectedColumns=Selected Columns
selectedColumns_help=Selected Columns
tables=Tables
tables_help=Tables
selectColumn=Select Column
statement=Statement
statement_help=Statement
order=Order
order_help=Order
cycle=Cycle
cycle_help=Cycle
cache=Cache
cache_help=cache
noCycle=No Cycle
noOrder=No Order
noCache=No Cache
cacheVal=Cache Value
cacheVal_help=Cache Value
cascade=CASCADE
reference=Reference
reference_help=Reference
checkText=Check
checkText_help=Check
asc=ASC
desc=DESC
sort=SORT
nosort=NOSORT
availableColumns=Available Columns
availableColumns_help=Available Columns
isReverse=Is Reverse
isReverse_help=Is Reverse
sortType=Sort
sortType_help=Sort
visibleType=Visible
visibleType_help=Visible
visible=VISIBLE
invisible=INVISIBLE
bitmap=BITMAP
emptyDBConfigureData=Empty DB Configure Details
systemType=System Type
userDefinedType=User Defined Type
dbNotConfigured=Please configure your DB details before Manage Columns.
downloadDBSchema_int=Download DBSchema
userDefinedTypeDialog=User Defined Types
manageUserType=Manage Type Columns
manageUserType_help=Manage Type Columns
columnType=Column Type
columnType_help=Column Type
numeric=NUMERIC
varChar=CHARACTER VARYING
charDBType=CHARACTER
loadSchema=Load Schema
loadSchema_help=Load Schema
userDefinedSchema=DB Schema 
save=Save
upload=Upload
download=Download
real=REAL
doublePrecision=DOUBLE PRECISION(FLOAT)
binaryDoublePrecision=DOUBLE PRECISION
longText=TEXT
blobByte=BYTEA
intervalField=INTERVAL
noTimezone=NO TIMEZONE
addNewVariable=+ New Variable
createVariableDialog=Create Variable
language=Language
language_help=Language
english=English
japanese=Japanese
spanish=Spanish
japanese_var1=Japanese Var-1
shape_send_alarm=Send Alarm
shape_end_execution=End Execution
shape_send_email=Send Email
shape_send_sms=Send SMS
alarmcode=Alarm Code
alarmcode_help=Alarm Code
severity=Severity
severity_help=Severity
information=Information
warning=Warning
critical=Critical
major=Major
minor=Minor
smtpHost=SMTP Host
smtpHost_help=SMTP Host
recipient=Recipient
recipient_help=Recipient
subject=Subject
subject_help=Subject
body=Body
body_help=Body
mimeContent=Mime Content
mimeContent_help=Mime Content
phoneNumberList=Phone Number List
phoneNumberList_help=Phone Number List
smsContent=SMS Content
smsContent_help=SMS Content
smsAdaptorType=SMS Adaptor Type
smsAdaptorType_help=SMS Adaptor Type
httpEvent=Http Event
agnity=AGNITY
generateApi=Generate API
generateApi_help=Generate API
planId=Plan ID
advHandlerAll=All
advHandlerPlay=Play
advHandlerPlayCollect=Play Collect
advHandlerPlayDisconnect=Play Disconnect
shape_routing_engine=Routing Engine
shape_route_play=Route Play
shape_route_play_collect=Route Play Collect
advanceReHandler=Advance RE Handlers
shape_route=Route
playCollect=Play Collect
play=Play
playDisconnect=Play Disconnect
TranslationError=Translation Error
disconnect=Disconnect
route=Route
directMs=Direct MS
flex=Flex
ignoreDigits=Ignore Digits
backspaceDigits=Backspace Digits
logicalAnd=Logical AND
logicalOr=Logical OR
leftShift=Left Shift
rightShit=Right Shift
concat=Concatenation
startRange=Start Range
endRange=End Range
rangeInput=Input Range
rangeOf=Range Of
contains=CONTAINS
setArgs=Set Arguments
arg=Argument
accountHierarchialType=Account Hierarchy
provider=Provider Based
subscriber=Subscriber Based
no_direct_account_relationship=No Direct Account Relationship
isSeqGeneratedField=Is Auto Seq Field
selectedSequence=Selected Sequence
apiVersion=Api Version
rePlayCollectRepeat=Repeat
rePlayCollectBarge=Barge
rePlayCollectFlex=Flex
rePlayCollectReturnKey=Return Key
rePlayCollectEscapeKey=Escape Key
rePlayCollectFirstDigitTimer=First Digit Timer (sec)
rePlayCollectExtraDigitTimer=Extra Digit Timer (sec)
rePlayCollectInterDigitTimer=Inter Digit Timer (sec)
rePlayCollectMinDigit=Min Digit
rePlayCollectMaxDigit=Max Digit
rePlayInterDigitCriticalTimer=Inter Digit Critical Timer (sec)
rePlayCollectLongDigitTimer=Long Digit Timer (sec)
rePlayCollectIgnoreDigits=Ignore Digits
rePlayCollectBackspaceDigits=Backspace Digits
partyToCharge=Party To Charge
maxCallPeriodDuration=Max Call Duration
releaseIfdurationExceeded=Release If Duration Exceeded
audibleIndicator=Audible Indicator
tariffSwitchInterval=Tariff Switch Interval
shape_apply_charge=Apply Charge
userError=User Error	
prearranged=Prearranged
reDropIvrOnCompletion=Drop IVR on Completion
reConnectionMode=Connection Mode
rePlayConnectionMode=Connection Mode
shape_trigger_rule=Trigger Rule
shape_automatic_code_gapping=Automatic Code Gapping
calledParty=Called Party
callingParty=Calling Party
newtorkMgmtClass=Network Management Class
factor=Factor
encounted=Encounted
abbeted=Abbeted
close=Close
tuiDataHandler=TUI Data Handler
shape_tui=TUI
uploadJson=Upload JSON
uploadJson_help=Upload JSON
defineKeys=Define Keys
defineKeys_help=Define Keys
key=Key
value=Value
invalidInput=Invalid Input
shape_enum=ENUM
role=Role
queryNum=Query Number
applyChargingReport=Apply Charging Report
ampersand=Ampersand
shape_avp_reader=AVP Reader
shape_avp_writer=AVP Writer
shape_diameter_cca=Diameter CCA
shape_diameter_ccr=Diameter CCR
defineAvp=Define AVP
avpname=AVP Name
avpVendorId=AVP Vendor ID
avpType=AVP Type
avprOutput=Output
avpwData=AVP Data
avpInfoHeading=Define AVP Information
avpCode=AVP code
avpListHolder=AVP List Variable
integer32=Integer32
integer64=Integer64
float32=Float32
float64=Float64
grouped=Grouped
octetString=Octet String
unsigned32=Unsigned32
unsigned64=Unsigned64
ccrAction=Requesting Action
directDebiting=Direct Debiting
refundAccount=Refund Account
checkBalance=Check Balance
priceEnquiry=Price Enquiry 
ccrSessionMode=Session Mode
initial=Initial
terminate=Terminate
ccrRealm=Route-Remote Realm
ccrAvpListHolder=AVP List
ccrIsSessionBased= Is Session Based
ccaReturnCode=Return Code
multiRoundAuth=DIAMETER_MULTI_ROUND_AUTH
diameterSuccess=DIAMETER_SUCCESS
diameterLimitedSuccess=DIAMETER_LIMITED_SUCCESS           
commandUnsupported=DIAMETER_COMMAND_UNSUPPORTED       
unableToDeliver=DIAMETER_UNABLE_TO_DELIVER         
realmNotServed=DIAMETER_REALM_NOT_SERVED          
diameterTooBusy=DIAMETER_TOO_BUSY                  
loopDetected=DIAMETER_LOOP_DETECTED             
redirectIndication=DIAMETER_REDIRECT_INDICATION       
appUnsupported=DIAMETER_APPLICATION_UNSUPPORTED
InvalidHdrBits=DIAMETER_INVALID_HDR_BITS          
invalidAvpBits=DIAMETER_INVALID_AVP_BITS          
unknownPeer=DIAMETER_UNKNOWN_PEER              
authenticationRejected=DIAMETER_AUTHENTICATION_REJECTED   
diameterOutOfSpace=DIAMETER_OUT_OF_SPACE
electionLost=ELECTION_LOST                      
avpUnsupported=DIAMETER_AVP_UNSUPPORTED           
unknownSessionId=DIAMETER_UNKNOWN_SESSION_ID        
authorizationRejected=DIAMETER_AUTHORIZATION_REJECTED    
invalidAvpValue=DIAMETER_INVALID_AVP_VALUE
missingAvp=DIAMETER_MISSING_AVP               
resourceExceeded=DIAMETER_RESOURCES_EXCEEDED        
contradictingAvps=DIAMETER_CONTRADICTING_AVPS        
avpNotAllowed=DIAMETER_AVP_NOT_ALLOWED           
tooManyTimesAvp=DIAMETER_AVP_OCCURS_TOO_MANY_TIMES 
noCommonApp=DIAMETER_NO_COMMON_APPLICATION
ccaAvpListHolder=AVP List    
unsupportedVersion=DIAMETER_UNSUPPORTED_VERSION       
unableToComply=DIAMETER_UNABLE_TO_COMPLY          
invalidBitInHeader=DIAMETER_INVALID_BIT_IN_HEADER     
invalidAvpLength=DIAMETER_INVALID_AVP_LENGTH
invalidMessageLength=DIAMETER_INVALID_MESSAGE_LENGTH    
invalidAvpBitcombo=DIAMETER_INVALID_AVP_BIT_COMBO     
noCommonSecurity=DIAMETER_NO_COMMON_SECURITY
creditControlNotApplicable=DIAMETER_CREDIT_CONTROL_NOT_APPLICABLE
equals=Equals
isSpsOnly=Is SPS Only Table
isVersionEnabled=Is Version Enabled
isVersionkeyRequired=Is versionKey Required
eventEnumResponseReceived=Enum Response Received
ccrUpdate=CCR-Update
ccrTerminate=CCR-Terminate
cca=CCA
zone=Zone
sender=Sender
receiver=Receiver
getValueFromList=Get Value from List
getNextValueFromList=Get Next Value from List
isBitPositionSet=Is Bit Position Set
cancelAndPrearrange=Cancel-Prearranged
creditLimitReached=DIAMETER_CREDIT_LIMIT_REACHED
defineRules=Define Rules
defineRules_help=Define Rules
manageAudit=Manage Audit
manageAudit_help=Manage Audit
ignoreAudit=Ignore Audit
ignoreAudit_help=Ignore Audit
expression=Expression
errorMessage=Error Message
errorOnTrue=Error On True
isInternalProperty=Internal Property
getLength=Get Length
setHeaders=Set SIP Headers
SIP_Headers=SIP Headers
isDigits=Is Digits
headername=Header Name
headervalue=Header Value
SIPHeaders=SIP Headers
srcPh=Source Phone
destPh=Destination Phone
shortMsg= Short Msg
CHECK_AND_RESERVE_COUNT=CHECK_AND_RESERVE_COUNT
RELEASE_COUNT=RELEASE_COUNT
IS_CALL_ALLOWED=IS_CALL_ALLOWED
INCREASE_COUNT=INCREASE_COUNT
UPDATE_ASSOCIATION=UPDATE_ASSOCIATION
GET_CALL_COUNT=GET_CALL_COUNT
callBarringFunction= Concurrent Call Barring Function
numberType= Number Type
TOLLFREE_NUMBER=TOLLFREE_NUMBER
TERMINATING_NUMBER=TERMINATING_NUMBER
number=Number
groupId= Group Id
groupLimit= Group Limit
numberLimit=Number Limit
callLimit= Call Limit Duration (in seconds) 
checkEmail= Send Email
emailContent= Content
emailSubject= Subject
gsmScfAddress= GSM SCF ADDRESS
relay=Relay
ApplicationId=Application Id
sendNot=Send Notification
sendShortMsg=Event short message received
shortMessageDelivered=Event short message delivered 
shUserRequest=Event SH User Data Response Received
eventSuccess=Event Success
leftPad=Left Padding
rightPad=Right Padding
currLocation=CURRENT LOCATION
msisdn=MSISDN
destinationRealm=Destination Realm
DoNotNeedInitiateActiveLocationRetrieval=DoNotNeedInitiateActiveLocationRetrieval
InitiateActiveLocationRetrieval=InitiateActiveLocationRetrieval
domainType=DOMAIN TYPE
cs_Domain=CS_DOMAIN
ps_Domain=PS_DOMAIN
protocol=Protocol
nextServiceApplicationId= Next Service AppId
float=Float
handleNextSS7Component=Process Next SS7 Component
outbountGateWayPoolId=Outbound GW Pool Id
outboundgatewayIdCheck=Outbound GW Check
appSessionId=Application Session ID
appID=Application ID
recieverId=Reciever Id
dialledNumber=Dialled Number
callingNumber=Calling Number
loginAgain=Back to login
logout=Logout
logout_help=Logout
changePassword=Change Password
changePassword_help=Change Password
tone=tone
handleTimerTimeout=Event timer timeout received
emailRecipients=Email Recipients
emailThreshold=Email Threshold Limit(In seconds)
broadcastDestination=BroadCast Destination List(Semicolon separated)
broadcast=Broadcast
LEG1=LEG1
LEG2=LEG2
callLeg=CallLeg
call-leg=CallLeg
parallelRinging=Parallel Ringing
serialRinging=Serial Ringing
tfNumber=Toll Free Number
enableQueuing=Enable Queuing
initialAnnEnabled=Initial Announcement Enabled
initialAnn=Initial Announcement
queueTimeoutAnn=Queue Timeout Announcement
queueTimeoutAnnEnabled=Queue Timeout Announcement Enabled
normalQueueSize=Normal Queue Size
normalQueueTimeout=Normal Queue Timeout (in secs)
normalQueueAnn=Normal Queue Announcement
normalQueueOverflowAnn=Normal Queue Overflow Announcement
queueOverflowAnnEnabled=Queue Overflow Announcement Enabled
priorityQueueSize=Priority Queue Size
priorityQueueTimeout=Priority Queue Timeout (in secs)
priorityQueuePIN=Priority Queue PIN
priorityQueueEnabled=Priority Queue Enabled
priorityQueuePINAnn=Priority Queue PIN Announcement
priorityQueueAnn=Priority Queue Announcement
priorityQueueOverflowAnn=Priority Queue Overflow Announcement
incorrectPINAnn=Incorrect PIN Announcement
moveToPriorityAnn=Move To Priority Announcement
maxRetriesFailedAnn=Max Retries Failed Announcement
priorityPINMaxRetries=Priority PIN Max Retries
priorityQueue=Priority Queue
activeCallsLimit=Active Calls Limit
cqOperation=Call Queuing Operation
INIT=INIT
CONNECTION_CONNECTED=CONNECTION_CONNECTED
CONNECTION_DISCONNECTED=CONNECTION_DISCONNECTED
MS_CONNECTION_DISCONNECTED=MS_CONNECTION_DISCONNECTED
ANNOUNCEMENT_PLAYED=ANNOUNCEMENT_PLAYED
DIGITS_COLLECTED=DIGITS_COLLECTED
PLAY_ANN_FAILED=PLAY_ANN_FAILED
PLAY_COLLECT_FAILED=PLAY_COLLECT_FAILED
TIMER_TIMEDOUT=TIMER_TIMEDOUT
CALL_DROPPED=CALL_DROPPED
lineAvailable=Line Available
queueTimeout=Queue Timeout
queueFull=Queue Full
lineBusyReturn=Line Busy Return
dequeuedLineAvailable=Dequeued Line Available
translationError=Translation Error
shape_initiate_ss7_call=Initiate SS7 Call
map=MAP
inap_cs1=INAP-CS1
inap_cs2=INAP-CS2
cap=CAP
message_name=Message Name
message_name_help=Message Name
sendRoutingInfoForLCS=SendRoutingInfoForLCS
initialDP=InitialDP
sccpCalledPartyInfo=SCCP Called Party Info
routingIndicator=Routing Indicator
ROUTING_SUBSYSTEM=ROUTING_SUBSYSTEM
ROUTING_GLOBALTITLE=ROUTING_GLOBALTITLE
pointCodeIndicator=Point Code Indicator
subsystemNoIndicator=Subsystem No Indicator
ssnAbsent=SSN Absent
ssnPresent=SSN Present
subsystemNumber=Subsystem Number
globalTitleIndicator=Global Title Indicator
GTIndicator0000=GTIndicator0000
GTIndicator0001=GTIndicator0001
GTIndicator0010=GTIndicator0010
GTIndicator0011=GTIndicator0011
GTIndicator0100=GTIndicator0100
nationalUse=National Use
1NationalAddress=1 National Address
translationType=Translation Type
encodingScheme=Encoding Scheme
natureOfAddressIndicator=Nature of Address Indicator
numberingPlan=Numbering Plan
gtDigits=GT Digits
sccpCallingPartyInfo=SCCP Calling Party Info
routingIndicator=Routing Indicator
ROUTING_SUBSYSTEM=ROUTING_SUBSYSTEM
ROUTING_GLOBALTITLE=ROUTING_GLOBALTITLE
protocolVersion=Protocol Version
protocolVersion_help=Protocol Version
NOT_SET=NOT SET
DP_PROTOCOL_VERSION_ANSI_96=DP_PROTOCOL_VERSION_ANSI_96
appContextIdentifier=App Context Identifier
appContextIdentifier_help=App Context Identifier
APPLICATION_CONTEXT_INTEGER=APPLICATION_CONTEXT_INTEGER
APPLICATION_CONTEXT_OBJECT=APPLICATION_CONTEXT_OBJECT
appContextName=App Context Name
appContextName_help=App Context Name
userInformationIdentifier=User Information Identifier
userInformationIdentifier_help=User Information Identifier
SET=SET
userInformation=User Information
userInformation_help=User Information
pointCode=Point Code
InitialDP=InitialDP
SendRoutingInfoForLCS=SendRoutingInfoForLCS
pcPresent=PC Present
pcAbsent=PC Absent
0=0
1NationalAddress=1 National Address
ssnAbsent=SSN Absent
ssnPresent=SSN Present
messageParameter=Message Parameter
messageParameter_config=Message Parameter Configuration
messageParameter_help=Message Parameter
00118605010101a011=00118605010101a011
00118605010101a011=00118605010101a011
messageParameter_settings=Message Parameter Settings
pName=Parameter Name
pName_help=Parameter Name
pValue=Parameter Value
pValue_help=Parameter Value
pType=Parameter Type
mlcNumber.digits=mlcNumber.digits
mlcNumber.noa=mlcNumber.noa
mlcNumber.np=mlcNumber.np
targetMS.msisdn.digits=targetMS.msisdn.digits
targetMS.msisdn.noa=targetMS.msisdn.noa
targetMS.msisdn.np=targetMS.msisdn.np
routingIndicator_help=Routing Indicator
pointCodeIndicator_help=Point Code Indicator
pointCode_help=Point Code
subsystemNoIndicator_help=Subsystem No Indicator
subsystemNumber_help=Subsystem Number
globalTitleIndicator_help=Global Title Indicator
nationalUse_help=National Use
translationType_help=Translation Type
encodingScheme_help=Encoding Scheme
natureOfAddressIndicator_help=Nature of Address Indicator
numberingPlan_help=Numbering Plan
gtDigits_help=GT Digits
protocol_help=Protocol
ES_EVEN=ES_EVEN
ES_NATIONAL_SPECIFIC=ES_NATIONAL_SPECIFIC
ES_ODD=ES_ODD
ES_UNKNOWN=ES_UNKNOWN
NA_INTERNATIONAL=NA_INTERNATIONAL
NA_NATIONAL_SIGNIFICANT=NA_NATIONAL_SIGNIFICANT
NA_RESERVED=NA_RESERVED
NA_SUBSCRIBER=NA_SUBSCRIBER
NA_UNKNOWN=NA_UNKNOWN
NP_DATA=NP_DATA
NP_GENERIC=NP_GENERIC
NP_ISDN_MOBILE=NP_ISDN_MOBILE
NP_ISDN_TEL=NP_ISDN_TEL
NP_LAND_MOBILE=NP_LAND_MOBILE
NP_MARITIME_MOBILE=NP_MARITIME_MOBILE
NP_NETWORK=NP_NETWORK
NP_TELEX=NP_TELEX
NP_UNKNOWN=NP_UNKNOWN
NP_GENERIC=NP_GENERIC
NP_NETWORK=NP_NETWORK
NP_ISDN_MOBILE=NP_ISDN_MOBILE
NP_RESERVED=NP_RESERVED
casGroup=CAS Group
sshUser=SSH User
sshPort=SSH Port
sshPassword=SSH Password
sshCnfPassword=Confirm Password
sshUser_help=SSH User
sshPort_help=SSH Port
sshPassword_help=SSH Password
sshCnfPassword_help=Confirm Password
httpport=HTTP Port
httpport_help=HTTP Port
debugging=Debugging
debug=Debug
disableDebug=Disable Debug
enableDebug=Enable Debug
applicationname=Application Name
timestamp=Date and Time
ipaddress=IP Address
casname=CAS Instance
debugApplication=Call Debug
callTraceFiles=Call Trace Files
passPolicyFiles=Password Policy
manualupload=Upload Call Trace File
lock=Lock
unlock=Unlock
uploadDebugFile= Upload Debug File
pollNewFiles=Poll New Files From CAS
domainname=Domain Name
object=Object
componenttype=Type
path=Object
elapsedtime=Elapsed Time
lockedby=Locked by
ctfsd=Call Trace File Path
ctfsd_help=Call Trace File Path
passwordNotMatch=Passwords do not match
emptyFieldErrorMsg=cannot be empty
Auditloglist=Audit Logs
PasswordPolicy=Password Policy

staticKey=Action
staticKey_help=Action
pegCountId=Peg Count Name
pegCountId_help=Peg Count Name
incrementByValue=Count
incrementByValue_help=Count
shape_peg_count=Peg Count
shape_http_ra=Http Ra

one=1
two=2
application_measurement_counter=Application Measurement Counter
shape_application_measurement_counter=Application Measurement Counter
measurementSetNames=Measurement Set Name
measurementSetNames_help=Measurement Set Name
accumulationInterval=Accumulation Interval (Sec)
accumulationInterval_help=Accumulation Interval (Sec)
setPegCount=Set Peg Count
setHttpHeaders=Set HTTP Headers
setPegCount_help=Set Peg Count
pegCountName=Peg Count Name
pegCountName_help=Peg Count Name
mode_help=Mode
mode=Mode
pegCounts=PEG Counts
setPegCount=Set Peg Count
pegCountSettings=Peg Count Settings
decrementBy=Decrement By
shape_playspeech=Play Speech
dropIvrOnCompletion=Drop IVR on Completion
barge=Barge
sendMode=Send Mode
connectionMode=Connection Mode
collectedText=Store Collected Text in
recognitiontime=Recognition Time(in sec)
speechcomplete=Speech Complete(in sec)
isRecordRequired=Is Record Required
isPlayRequired=Is Play Required
speechLanguage=Speech Language
isRecordRequired_help=Is Record Required
isPlayRequired_help=Is Play Required
deployOn=Deploy On
availableGroups=Available Groups
activateAll=Activate All
deactivateAll=Deactivate All
startAll=Start All
stopAll=Stop All
undeployAll=Undeploy All
activateAll_help=Activate All
deactivateAll_help=Deactivate All
startAll_help=Start All
stopAll_help=Stop All
undeployAll_help=Undeploy All
serverIp=Server IP
httpRaName=Http RA 
httpRaName_help=Http RA
httpRaName =Http RA 
get=GET
put=PUT
post=POST
delete=DELETE
patch=PATCH
httpRaCountId=URL

method=HTTP Method
content=HTTP Content
contentType=HTTP Content Type
reqTimeout=HTTP Req Timeout (ms)
outHttpResp=HTTP Response Code Received
outHttpContent=HTTP Content Received
httpRaName=Http RA 
httpheader=HTTP Headers
headervalue=Header Value
headername=Header Name
setHttpHeaders_help=setHttpHeaders
outHttpContent_help=outHttpContent
outHttpResp_Help=outHttpResp
reqTimeout_Help=reqTimeout
contentType_Help=contentType
content_Help=content
method_Help=method
url_Help=url
max20chars=Max 20 Chars
eventCallDropped=EVENT CALL DROPPED

logging=Logging
loggingMode_help=Logging Mode
logStatement_help=Log Statement
shape_logging=Logging
loggingMode=Logging Mode
logStatement=Log Statement
warn=WARN
info=Info

