Userlist=User Details
loginid=Login ID
password=Password
confirmPassword=Confirm Password
name=Name
accessibleDomainList=Accessible Domains List
adminPriviliges=Admin Privileges
createdOn=Created On
lastlogin=Last Login
status=Status
action=Actions
isAdmin=Admin Privileges
accessAllDomains=Access All Domains
addNew=Add
update=Update
delete=Delete
insert=Insert
load=Load
unlock=Force Unlock
unlock_help=Force Unlock
loginid_help=Login ID
password_help=Password
isAdmin_help=Admin Privileges
confirmPassword_help=Confirm Password
accessAllDomains_help=Access All Domains
name_help=Name
accessibleDomainList_help=Accessible Domain List
adminPriviliges_help=Admin Priviliges
createdOn_help=Created On
lastlogin_help=Last Login
action_help=Actions
addNew_help=Add
update_help=Update
delete_help=Delete
insert_help=Insert
load_help=Load
status_help=Status
applicationname=Application Name
timestamp=Date and Time
callingParty=Calling Party
calledParty=Called Party
ipaddress=IP Address
casname=CAS Instance
callTraceFiles=Call Trace Files
passPolicyFiles=Password Policy
manualupload=Manual Upload
uploadDebugFile= Upload Debug File
pollNewFiles=Poll New Files From CAS
domainname=Domain Name
allowMultiplApps=Support Multiple Apps
protocolList=Protocol List
allowMultiplApps_help=Support Multiple Apps
protocolList_help=Protocol List
failedServerResponse=The following error(s) occurred on sending your request to server:
failedUnlockUser=User is not locked.
failedValidation=Form validation failed due to following error(s):
Domainlist=Domain Details
Auditloglist=Audit Logs
user=Login ID
ip=IP address
date=Date and Time
domain=Domain
operation=Operation
description=Description
status=Status
searchKey=Search
search=Search
clear=Clear
search_help=Search
clear_help=Clear
search_placeholder=Type here to search..
policydetails=Policy Details
passpolicyname=Password Policy Name
maxFailAttempts=Max failed login attempt
passExpDays=Password expiry days
minLength=Min. length of password

passwordPolicy=Password Policy
minDigits=Min. number of digits in password
minSplChar=Min. number of special char in password
minUpperChar=Min. no of upper case characters in password
minLowerChar=Min. no of Lower case characters in password
numMultLogin=Number of multiple login allowed 
numOldPass=Number of old password to be stored
minReuseDays=Password reused after min days
suspendFirstLogin=Suspend first login account in days  
suspendInactiveAccount=Number of Days before Inactive Account Lock 
policyId=policyId
policyName=PolicyName 